1111111111111
10P1000000001
1000011111011
100011E00CCC1
1111111111111
